        0               1           2               3           4               5           6
	############# ############# #############               ############# #############
	#K  SS S    # # ES      SS# #E         E#               #      S  S # #    SS    E#
	#SS SE  S SH# #    S  S   # #           #               #  S   E    # # S S       #
	# S S S   SS# # S      E  # #           #               #           # # S S SSS   #
0	# S E S SS   L             O      G     #               # E   H S   # # S S K S  S#
	# SS S  S  S# #S  E     S # #           #               #           # #SS  S ES   #
	#  S SSSS S # #           # #           #               #   S       # #    SSSSS S#
	#           # #  S   S  S # #E         E#               #        S  # # S         #
	############# ###### ###### #############               ###### ###### ###### ######
                       	    O                                         L             O
	              ###### ###### ############# ############# ###### ###### ###### ###### #############
	              #           # #    SK   S # #           # #           # #S          # #G     E    #
	              #  E      S # #  S SSSS  S# #           # #  E        # # S         # #SSSSSSSSSS #
	              #   E    S  # #  S     S  # #           # #           # #  S        # # S   E   S #
1	              #       S    O   SSS   ES # #   BOZZZ   # #   E   E    O    SSSSS    O   S SSSS S #
	              #  E   S    # #    S S S  # #           # #           # #        S  # #  S    S SE#
	              #     S     # # E  S S   S# #           # #           # #         S # #  SSSS S S #
	              #    S      # #      S S  # #           # #       E   # #          S# #       S   #
	              ###### ###### ############# ###### ###### ###### ###### ###### ###### ###### ######
                            O                           B             O             O             O
	############# ###### ###### ############# ###### ###### ###### ###### ###### ###### ###### ######
	#           # #    S      # #          E# # S       S # #           # #           # #           #
	#   S    S  # #    SSS  E # #     E     # #  S     S  # #  E   SSS  # #   E       # #       E   #
	#   S    S  # #      S    # #        SSS# #   S   S   # #     SSS   # #           # #   E       #
2	#   S EE S   O      S      O         SP  O             O     SSS    # #            O            #
	# SSSSSSSSSS# #  SSSE     # #        SSS# #           # #   SSS   E # #  E        # #           #
	#           # #    SS     # #   E       # #           # #  SSS      # #      E    # #     E     #
	#           # #           # #           # #           # #           # #           # #           #
	###### ###### ############# ############# ############# ###### ###### ###### ###### #############
              O                                                       O             O
	###### ###### ############# ############# ############# ###### ###### ###### ######
	#     E     # #  SS ES    # #  E     S  # #   SS SS   # #   S       # # E  S S    #
	#      E    # # S     S   # #           # #  S     S  # #    S      # #    SKS    #
	#    SSSSSSS# #S   SS  SS # #      SS   # # S       S # #  S  S     # #    SSS  E #
3	#    S       O    S  S     O    S S     # #            O    ES S     O            #
	#    S      # #  S    SS  # #  S     E  # # S       S # #       S   # #    E      #
	#     SS    # #     E     # #           # #  S     S  # #    SE     # #           #
	#           # #           # #           # #   SS SS   # #   S    SS # #           #
	############# ############# ###### ###### ###### ###### ############# #############
                                          O             O
	############# ############# ###### ###### ###### ###### #############
	#           # #           # #           # #           # #    K      #
	#  SSSSSSS  # #  S   E    # #  SSSSSSS  # #  SSSSSSS  # #  SSSSSSS  #
	#  S    E   # #  S        # #  SE       # #  SE       # #  S     S  #
4	#  SSSSSSS   L   S         L   SSSSS     O   SSSSS     O   SSSSSSS  #
	# B     ES  # #  S     E  # #  SE       # #  SE       # #  S        #
	#  SSSSSSS  # #  SSSSSSS  # #  SSSSSSS  # #  SSSSSSS  # #  S   E    #
	#  E        # #           # #           # #           # #          P#
	############# ############# ############# ############# #############
